Get out
An Interactive Fiction by Dora
Release 1 / Serial number 240204 / Inform 7 v10.1.2 / D

You woke up on the cold floor of dark room. You don't know how you got here or where you are. All you can see are two doors and a few items scattered on the aorund around you. You look up, there is a mirror on one of the walls and next to it is an old broken clock. Above each door it says where tey lead. The red door leads to exit and the blue one leads to attic. You don't know if the time is right but it says it's almost 2.

Chamber
Moody dark room with things scattered on the floor.

If you go through them, you could find something of value.

You can also see an Exit door, an Attic door, Mirror and Old broken clock here.

>ask lupus about
You can ask about Who are you?, What are you?, or WTF.

>ask lupus about
You can ask about Who are you?, What are you?, or WTF.

>s
(first opening The Rusty front door)
It seems to be locked.

>s
(first opening The Rusty front door)
It seems to be locked.

>unlock door
(with the House Key)
You unlock The Rusty front door.

>s
(first opening The Rusty front door)

Kitchen
A boring old room.

You can see The Rusty front door and Wooden table (closed) here.

* * *

>examine scattered things
In Scattered things is Blue Key.

>i
You are carrying:
  Blue Key
  Fork
  a House Key

>examine attic door
You unlock the attic door with the blue key.

>unlock attic door with blue key
You unlock the attic door with the blue key.

>e
The exit door blocks your way east. Perhaps you should try opening it if you can.

>open exit door
It seems to be locked.

>unlock exit door
What do you want to unlock the Exit door from The Chamber with?

>eaxmine exit door
You can't see any such thing.

>examine exit door
This sturdy door leads to the exit. It seems to be locked. You can unlock it with the red key.

>i
You are carrying:
  Blue Key
  Fork
  a House Key

>unlock attic door with blue key
You unlock the attic door with the blue key.

* * *

>e
The exit door blocks your way east. Perhaps you should try opening it if you can.

>w
(first opening the Attic door)

Attic
The attic is filled with nothing the spiderwebs and dust.

You can see an Attic door, Note and Unknown animal here.

>take note
Rex has something for you.

Taken.

>drop
What do you want to drop?

>read note
You see nothing special about Note.

>examine unknown animal
Who is this?

>ask unknown animal about
You can ask about Who are you?, What are you?, or Something to say.

>ask unknown animal about who are you
My name is Rex. What am i doing in the attic? How did i get here?

>ask rex about something to say
I have a red key for you!

>i
You are carrying:
  a Red Key
  Note
  Blue Key
  Fork
  a House Key

>s
Chamber
Moody dark room with things scattered on the floor.

If you go through them, you could find something of value.

You can also see an Attic door, an Exit door from The Chamber, Mirror and Old broken clock here.

>unlock exit door with red key
You unlock the exit door with the red key.

>e
The exit door blocks your way east. Perhaps you should try opening it if you can.

>open exit door
You open the Exit door from The Chamber.

>e
Hallway
The hallway leads to your freedom.

On picture, you can see yourself having fun in an open green field. You have neber been there so it must be the future.

You can also see an Exit door from The Chamber and Passage here.

>examine passage
You see nothing special about Passage.

* * *

>examine scattered things
In Scattered things is Blue Key.

>unlock attic door
(with Blue Key)
You unlock the attic door with the blue key.

>unlock attic door with blue key
You unlock the attic door with the blue key.

>w
(first opening the Attic door)

Attic
You can see an Attic door, a Red Key, Note and Unknown animal here.

>ask rex about
You can ask about Who are you?, What are you?, or Something to say.

* * *

>unlock attic door
(with Blue Key)
You unlock the attic door with the blue key.

>w
(first opening the Attic door)

Attic
The attic is filled with nothing but spiderwebs and dust.

You can see an Attic door, Note and Unknown animal here.

>ask unknown animal about
You can ask about Who are you?, What are you?, or Something to say.

>ask unknown animal about something to say
I have a red key for you!

>i
You are carrying:
  Red Key
  Blue Key

>ask unknown animal about who are you
You can't see any such thing.

>examine
What do you want to examine?

>examine unknown animal
You can't see any such thing.

>look
Attic
The attic is filled with nothing but spiderwebs and dust.

You can see an Attic door, Note and Rex here.

* * *

>i
You are carrying:
  Red Key
  Blue Key

* * *

>w
(first opening the Attic door)

Attic
The attic is filled with nothing but spiderwebs and dust.

You can see an Attic door, Note and Unknown animal here.

>take nore
You can't see any such thing.

>take note
Rex has something for you.

Taken.

>ask unknown animal about
You can ask about Who are you?, What are you?, or Something to say.

* * *

I beg your pardon?

I beg your pardon?

>ask rex about
You can ask about Who are you?, What are you?, or Something to say.

>ask rex about something to say
I have a red key for you!

>i
You are carrying:
  Red Key
  Note
  Blue Key

>s
Chamber
Moody dark room with things scattered on the floor.

If you go through them, you could find something of value.

You can also see an Attic door, an Exit door, Mirror and Old broken clock here.

>e
The exit door blocks your way east. Perhaps you should try opening it if you can.

>unlock exit doors
What do you want to unlock the Exit door with?

>unlock exit doors with red key
You unlock the exit door with the red key.

>e
The exit door blocks your way east. Perhaps you should try opening it if you can.

>open exit doors
You open the Exit door.

>e
Hallway
The hallway leads to your freedom.

In the picture, you can see yourself having fun in an open green field. You have never been there so it must be the future.

You can also see Passage and an Exit door here.

>examine passage
Through the passage, you can see the bright light. It is so bright you can't see anything else.

>w
Chamber
Moody dark room with things scattered on the floor.

If you go through them, you could find something of value.

You can also see an Exit door, an Attic door, Mirror and Old broken clock here.

>e
Hallway
The hallway leads to your freedom.

In the picture, you can see yourself having fun in an open green field. You have never been there so it must be the future.

You can also see an Exit door and Passage here.

>n
You can't go there yet, you must find something first.

>s
You can't go that way.

>w
Chamber
Moody dark room with things scattered on the floor.

If you go through them, you could find something of value.

You can also see an Exit door, an Attic door, Mirror and Old broken clock here.

* * *

>e
Hallway
The hallway leads to your freedom.

In the picture, you can see yourself having fun in an open green field. You have never been there so it must be the future.

You can also see an Exit door and Passage here.

>e
You can't go that way.

>puch picture
That's not a verb I recognise.

>examine picture
You see nothing special about Picture.

>push picture
Good thing I moved the picture. Now i have a lockpick, it might come in handy someday.

Nothing obvious happens.

>n
As you step through the passage, you're enveloped by a bright light, and when your vision clears, you find yourself standing in an open green field.

Green Field
The sun shines brightly and the grass is lush and green. It's peaceful here.

You can see Passage and Big Fruity Tree (in which is an apple) here.

This is it, freedom finally!.

>s
You've found your freedom, and there's no going back now.

>w
You can't go that way.

>e
You can't go that way.

>n
You can't go that way.

>take apple
Taken.

>eat apple
As you finish the apple, a drowsy feeling overcomes you, and your surroundings start to blur...

Street
You find yourself on the street your home is at. Your house looms in front of you, its door locked.

You eat the apple. Not bad.

>w
House
It's your cozy home, familiar and welcoming. Your bed is here, you just want to rest now.

You can see a house door here.

>e
Street
You find yourself on the street your home is at. Your house looms in front of you, its door locked.

>n
You can't go that way.

>s
You can't go that way.

>e
You can't go that way.

>w
House
It's your cozy home, familiar and welcoming. Your bed is here, you just want to rest now.

You can see a house door here.

>i
You are carrying:
  Lockpick
  Red Key
  Note
  Blue Key

>n
(first opening the house door)
It seems to be locked.

>s
You can't go that way.

>e
Street
You find yourself on the street your home is at. Your house looms in front of you, its door locked.

>e
You can't go that way.

* * *

>n
You can't go that way.

>w
House
It's your cozy home, familiar and welcoming. Your bed is here, you just want to rest now.

You can see a house door here.

>s
You can't go that way.

>n
(first opening the house door)
It seems to be locked.

>w
You can't go that way.

>e
Street
You find yourself on the street your home is at. Your house looms in front of you, its door locked.

>w
House
It's your cozy home, familiar and welcoming. Your bed is here, you just want to rest now.

You can see a house door here.

>w
You can't go that way.

>s
You can't go that way.

* * *

>n
(first opening the house door)
It seems to be locked.

>look
House
It's your cozy home, familiar and welcoming. Your bed is here, you just want to rest now.

You can see a house door here.

>unlock house door with lockpick
You barely know how to use the lockpick but you manage to unlock your house door.

>n
(first opening the house door)

Home
You can see a house door and a bed here.

>look
Home
You can see a house door and a bed here.

>w
You can't go that way.

* * *

>e
You can't go that way.

>s
House
It's your cozy home, familiar and welcoming. Your bed is here, you just want to rest now.

You can see a house door here.

>n
Home
You can see a house door and a bed here.

>n
You can't go that way.

>sleep in bed
You tuck yourself into bed, and sleep comes easily after such a long journey. This is the rest you've desperately needed.

    *** You have won! ***

Would you like to RESTART, RESTORE a saved game, QUIT or UNDO the last command?

>undo
Home
[Previous turn undone.]

>sleep in bed
You tuck yourself into bed, and sleep comes easily after such a long journey. This is the rest you've desperately needed.

    *** You have won! ***

Would you like to RESTART, RESTORE a saved game, QUIT or UNDO the last command?

>restore
Restore failed.

Would you like to RESTART, RESTORE a saved game, QUIT or UNDO the last command?

>restart
Get out
An Interactive Fiction by Dora
Release 1 / Serial number 240204 / Inform 7 v10.1.2 / D

You woke up on the cold floor of dark room. You don't know how you got here or where you are. All you can see are two doors and a few items scattered on the aorund around you. You look up, there is a mirror on one of the walls and next to it is an old broken clock. Above each door it says where tey lead. The red door leads to exit and the blue one leads to attic. You don't know if the time is right but it says it's almost 2.

Chamber
Moody dark room with things scattered on the floor.

If you go through them, you could find something of value.

You can also see an Exit door, an Attic door, Mirror and Old broken clock here.

* * *

>w
(first opening the Attic door)

Attic
The attic is filled with nothing but spiderwebs and dust.

You can see an Attic door, Note and Unknown animal here.

>take note
Rex has something for you.

Taken.

>examine unknown animal
Ask it something!

>ask unknown animal about
You can ask about Who are you?, What are you?, or Something to say.

* * *

>ask unknown animal about who are you
You can't see any such thing.

>ask unknown animal about who are you
You can't see any such thing.

>ask rex about who are you
My name is Rex. What am i doing in the attic? How did i get here?

* * *

>examine scattered things
In Scattered things is Blue Key.

>unlock attic door with blue key
You unlock the attic door with the blue key.

* * *

>w
(first opening the Attic door)

Attic
The attic is filled with nothing the spiderwebs and dust.

You can see an Attic door, Note and Unknown animal here.

>ask unknown animal about something to say
I have a red key for you!

>s
Chamber
Moody dark room with things scattered on the floor.

If you go through them, you could find something of value.

You can also see an Attic door, an Exit door, Mirror and Old broken clock here.

>unlock exit door
(with Blue Key)
That doesn't seem to fit the lock.

>unlock exit door with red key
You can't see any such thing.

>open exit door
It seems to be locked.

>e
The exit door blocks your way east. Perhaps you should try opening it if you can.

>n
You can't go that way.

>push picture
You can't see any such thing.

>n
You can't go that way.

* * *

>s
You can't go that way.

>n
You can't go that way.

>look
Chamber
Moody dark room with things scattered on the floor.

If you go through them, you could find something of value.

You can also see an Attic door, an Exit door, Mirror and Old broken clock here.

>n
You can't go that way.

>w
Attic
The attic is filled with nothing the spiderwebs and dust.

You can see an Attic door, Note and Rex here.

>e
You can't go that way.

>s
Chamber
Moody dark room with things scattered on the floor.

If you go through them, you could find something of value.

You can also see an Attic door, an Exit door, Mirror and Old broken clock here.

>look
Chamber
Moody dark room with things scattered on the floor.

If you go through them, you could find something of value.

You can also see an Attic door, an Exit door, Mirror and Old broken clock here.

>examine big fruity tree
You can't see any such thing.

>i
You are carrying:
  Blue Key

>eat apple
You can't see any such thing.

>n
You can't go that way.

* * *

>s
You can't go that way.

>w
Attic
The attic is filled with nothing the spiderwebs and dust.

You can see an Attic door, Note and Rex here.

* * *

>e
You can't go that way.

>e
You can't go that way.

>w
You can't go that way.

>examine house door
You can't see any such thing.

>unlock house door with lockpick
You can't see any such thing.

>n
You can't go that way.

>examine bed
You can't see any such thing.

>sleep bed
I only understood you as far as wanting to sleep.

>sleep in bed
You can't see any such thing.

* * *

>unlock attic door with blue key
You unlock the attic door with the blue key.

>w
(first opening the Attic door)

Attic
The attic is filled with nothing but spiderwebs and dust.

You can see an Attic door, Note and Unknown animal here.

>ask unknown animal about something to say
I have a red key for you!

>i
You are carrying:
  Blue Key

>i
You are carrying:
  Blue Key

>ask unknown animal about who are you
You can't see any such thing.

>ask unknown animal about
You can't see any such thing.

* * *

>w
(first opening the Attic door)

Attic
The attic is filled with nothing but spiderwebs and dust.

You can see an Attic door, Note and Unknown animal here.

>examine unknown beast
You can't see any such thing.

>examine unknown animal
Who is this?

>ask rex about
You can ask about Who are you?, What are you?, or Something to say.

>ask unknown animal about who are you
My name is Rex. What am i doing in the attic? How did i get here?

>take note
Rex has something for you.

Taken.

>ask rex about
You can ask about Who are you?, What are you?, or Something to say.

* * *

>take note
Rex has something for you.

Taken.

>examine unknown animal
Who is this?

>ask unknown animal about who are you
My name is Rex. What am i doing in the attic? How did i get here?

* * *

>i
You are carrying:
  a Red Key
  Note
  Blue Key
  Fork
  a House Key

>e
You can't go that way.

>s
Chamber
Moody dark room with things scattered on the floor.

If you go through them, you could find something of value.

You can also see an Attic door, Exit door, Mirror and Old broken clock here.

>n
Not yet!

>unlock attic door with red key
That's unlocked at the moment.

* * *

>examine scattered things
In Scattered things is Blue Key.

>unlock attic door with scattered thing
I only understood you as far as wanting to unlock the Attic door with Scattered things.

>unlock attic door with blue key
You unlock the attic door with the blue key.

>ask unknown animal about
You can't see any such thing.

>e
The exit door blocks your way east. Perhaps you should try opening it if you can.

* * *

>w
(first opening the Attic door)

Attic
The attic is filled with nothing the spiderwebs and dust.

You can see an Attic door, Note and Unknown animal here.

>ask unknown animal about
You can ask about Who are you?, What are you?, or Something to say.

* * *

>s
Chamber
Moody dark room with things scattered on the floor.

If you go through them, you could find something of value.

You can also see an Attic door, an Exit door, Mirror and Old broken clock here.

>unlock exit door with red key
You unlock the exit door with the red key.

>open exit door
You open the Exit door.

>w
Attic
The attic is filled with nothing the spiderwebs and dust.

You can see an Attic door, Note and Rex here.

>s
Chamber
Moody dark room with things scattered on the floor.

If you go through them, you could find something of value.

You can also see an Attic door, an Exit door, Mirror and Old broken clock here.

>e
Hallway
The hallway leads to your freedom.

In the picture, you can see yourself having fun in an open green field. You have never been there so it must be the future.

Through the passage, you can see the bright light. It is so bright you can't see anything else.

You can also see an Exit door here.

>examine picture
You see nothing special about Picture.

>push pisture
You can't see any such thing.

>push picture
Good thing I moved the picture. Now i have a lockpick, it might come in handy someday.

Nothing obvious happens.

>i
You are carrying:
  Lockpick
  a Red Key
  Blue Key
  Fork
  a House Key

>examine passage
You see nothing special about Passage.

* * *

>examine unknown beast
What is this thing?

>ask unknown beast about who are you
My name is Lupus. What am i doing in your bedroom?

>look
Bedroom
A cluttered room that is a mess. Clothes are everywhere, and the room is hot! Maybe you should clean up after yourself and open the window!

You can see The Rusty front door, Lupus, Pile of clothes, Goro, Ulfr, Zegrath and an Archer here.

>i
You are carrying:
  Fork
  a House Key

>drop fork
Dropped.

>look
Bedroom
A cluttered room that is a mess. Clothes are everywhere, and the room is hot! Maybe you should clean up after yourself and open the window!

You can see Fork, The Rusty front door, Lupus, Pile of clothes, Goro, Ulfr, Zegrath and an Archer here.

>take fork
Taken.

>i
You are carrying:
  Fork
  a House Key

>e
Not yet!

* * *

>examine unknown beast
What is this thing?

>examine unknown beast
You can't see any such thing.

* * *

>i
You are carrying:
  Fork
  a House Key

>examine scattered things
In Scattered things is a Blue Key.

You find a blue key among the things.

>i
You are carrying:
  a Blue Key
  a Red Key
  Fork
  a House Key

>unlock attic door
What do you want to unlock the Attic door with?

>unlock attic door with a house key
That doesn't seem to fit the lock.

>unlock attic door with a blue key
You unlock the attic door with the blue key.

>i
You are carrying:
  Blue Key
  Fork
  a House Key

>n
Not yet!

>w
(first opening the Attic door)

Attic
You can see an Attic door and a Red Key here.

* * *

>i
You are carrying:
  a Blue Key
  a Red Key
  Fork
  a House Key

>unlock attic doors with blue key
That key won't work for this door.

>unlock attic with red key
That key won't work for this door.

>unlock attic with the Blue Key
That key won't work for this door.

* * *

>i
You are carrying:
  a Blue Key
  a Red Key
  Fork
  a House Key

>unlock attic with blue key
Debug: Attempting to unlock with the Attic door.
That key won't work for this door.

* * *

>i
You are carrying:
  Fork
  a House Key

>open attic door
It seems to be locked.

>open exit door
It seems to be locked.

>unlock exit door
What do you want to unlock the Exit door with?

>examine scattered things
In Scattered things is Blue Key.

* * *

>w
(first opening the Attic door)

Attic
You can see an Attic door, a Red Key, Note and Unknown animal here.

>examine unknown animal
Who is this?

>ask unknow animal about who aore you
You can't see any such thing.

>ask unknow animal about who are you
You can't see any such thing.

>ask unknow animal about
You can't see any such thing.

>ask unknown animal about
You can ask about Who are you?, What are you?, or Something to say.

* * *

>ask unknown animal about who are you
My name is Rex. What am i doing in the attic? How did i get here?

>ask unknown animal about something to say
You can't see any such thing.

>ask rex about something to say
I have a red key for you!

>i
You are carrying:
  a Red Key
  Blue Key
  Fork
  a House Key

>look
Attic
You can see an Attic door, Note and Rex here.

>w
You can't go that way.

* * *

>s
Chamber
Moody dark room with things scattered on the floor.

If you go through them, you could find something of value.

You can also see an Attic door, an Exit door, Mirror and Old broken clock here.

>w
Attic
You can see an Attic door, Note and Rex here.

>s
Chamber
Moody dark room with things scattered on the floor.

If you go through them, you could find something of value.

You can also see an Attic door, an Exit door, Mirror and Old broken clock here.

>unlock exit door with a red key
You unlock the exit door with the red key.

>i
You are carrying:
  a Red Key
  Blue Key
  Fork
  a House Key

>n
You can't go that way.

>e
Not yet!

>n
You can't go that way.

>open exit door
You open the Exit door.

>e
Not yet!

>look
Chamber
Moody dark room with things scattered on the floor.

If you go through them, you could find something of value.

You can also see an Attic door, an Exit door, Mirror and Old broken clock here.

>w
Attic
You can see an Attic door, Note and Rex here.

* * *

>s
Chamber
Moody dark room with things scattered on the floor.

If you go through them, you could find something of value.

You can also see an Attic door, an Exit door, Mirror and Old broken clock here.

>e
Not yet!

* * *

>n
Not yet!

>s
The Rusty old door

>s
You can't go that way.

>n
Bedroom
A cluttered room that is a mess. Clothes are everywhere, and the room is hot! Maybe you should clean up after yourself and open the window!

You can see Pile of clothes, Lupus, Goro, Ulfr, Zegrath and an Archer here.

>s
The Rusty old door

>unlock door with key
You can't see any such thing.

* * *

>n
Not yet!

>w
(first opening the Attic door)
It seems to be locked.

>take mirror
That's fixed in place.

>take old broken clock
Taken.

>i
You are carrying:
  Old broken clock
  Fork
  a House Key

>drop old broken clock
Dropped.

>i
You are carrying:
  Fork
  a House Key

>take scattered things
Taken.

>i
You are carrying:
  Scattered things
    Blue Key
  Fork
  a House Key

* * *

>open attic door
It seems to be locked.

>attic door
That's not a verb I recognise.

>unlock attic door
What do you want to unlock the Attic door with?

>about attic door
You can't see any such thing.

>open exit door
It seems to be locked.

>w
(first opening the Attic door)
It seems to be locked.

>n
Not yet!

>e
You can't go that way.

>s
You can't go that way.

>examine scattered things
In Scattered things is Blue Key.

* * *

>unlock attic door with blue key
You unlock the attic door with the blue key.

>n
Not yet!

>w
(first opening the Attic door)

Attic
You can see an Attic door, a Red Key, Note and Unknown animal here.

>takae note
That's not a verb I recognise.

>take note
Rex has something for you.

Taken.

>s
Chamber
Moody dark room with things scattered on the floor.

If you go through them, you could find something of value.

You can also see an Attic door, Exit door, Mirror and Old broken clock here.

* * *

>n
Not yet!

>w
Attic
You can see an Attic door, a Red Key and Unknown animal here.

>ask unknown animal about
You can't see any such thing.

>ask unknown animal about who are you
You can't see any such thing.

* * *

>open exit door
It seems to be locked.

>examine scattered thing
I only understood you as far as wanting to examine Scattered things.

>examine scattered things
In Scattered things is Blue Key.

>drop blue key
Dropped.

>unlock attic door
What do you want to unlock the Attic door with?

>i
You are carrying:
  Fork
  a House Key

* * *

>open exit door
It seems to be locked.

>n
Not yet!

* * *

>w
(first opening the Attic door)
It seems to be locked.

>s
You can't go that way.

* * *

>e
You can't go that way.

>examine scattered things
In Scattered things is Blue Key.

* * *

>i
You are carrying:
  Blue Key
  Fork
  a House Key

>open attic door
It seems to be locked.

>unlock attic door with blue key
You don't have the right key to unlock the attic door.

>unlock attic door with Blue Key
You don't have the right key to unlock the attic door.

>unlock attic door with the Blue Key
You don't have the right key to unlock the attic door.

* * *

>s
(first opening The Rusty front door)
It seems to be locked.

>n
Bedroom
A cluttered room that is a mess. Clothes are everywhere, and the room is hot! Maybe you should clean up after yourself and open the window!

You can see Pile of clothes, Lupus, Goro, Ulfr, Zegrath and an Archer here.

>e
You can't go that way.

* * *

>n
You can't go that way.

>w
You can't go that way.

>s
Kitchen
A boring old room.

>take pile of clothes
You can't see any such thing.

>n
Bedroom
A cluttered room that is a mess. Clothes are everywhere, and the room is hot! Maybe you should clean up after yourself and open the window!

You can see Pile of clothes, Lupus, Goro, Ulfr, Zegrath and an Archer here.

>take pile of clothes
Taken.

>i
You are carrying:
  Pile of clothes

* * *

>take pile of clothes
Taken.

>s
Kitchen
A boring old room.

You can see an Archer and Wooden table (closed) here.

>open wooden table
You open Wooden table, revealing Knife.

>take knife
Taken.

* * *

>s
(first opening The Rusty front door)
It seems to be locked.

>unlock the door
(with the House Key)
You unlock The Rusty front door.

>look
Bedroom
A cluttered room that is a mess. Clothes are everywhere, and the room is hot! Maybe you should clean up after yourself and open the window!

You can see The Rusty front door, Pile of clothes, Lupus, Goro, Ulfr, Zegrath and an Archer here.

>s
(first opening The Rusty front door)

Kitchen
A boring old room.

You can see The Rusty front door and Wooden table (closed) here.

>n
Bedroom
A cluttered room that is a mess. Clothes are everywhere, and the room is hot! Maybe you should clean up after yourself and open the window!

You can see The Rusty front door, Pile of clothes, Lupus, Goro, Ulfr, Zegrath and an Archer here.

>ask goro about
I didn't understand that sentence.

>ask lupus about wtf
My thouts exacty!

* * *

>take pile of clothes
Taken.

>look
Bedroom
A cluttered room that is a mess. Clothes are everywhere, and the room is hot! Maybe you should clean up after yourself and open the window!

You can see Lupus, Goro, Ulfr and Zegrath here.

>s
Kitchen
A boring old room.

You can see an Archer here.

* * *

>w
(first opening the Attic door)
It seems to be locked.

* * *

>n
Not yet!

>examine scattered things
In Scattered things is Blue Key.

>unlock attic door with the blue key
You unlock the attic door with the blue key.

>w
(first opening the Attic door)

Attic
You can see an Attic door, a Red Key, Note and Unknown animal here.

>examine unknown animal
You can't see any such thing.